NO         ./textures/tt.xpm
SO ./textures/paint.xpm        
EA        ./textures/rp.xpm

F 33,33,33
WE ./textures/pb.xpm
C 155,206,255


111111111111111111111111111111111111111
                     11               1
                      1
                                      111
        1111111111111111111111111     1
1111111111111000000000110001
1011000001110000000000001111
1111111111111111111111111111111111111
100100000000000002220000111111111
111111111011000001110000000000001
100000000011222221110111112111111
11110111111111011100000010001
11110111111111011101010010001
11000000110101211100000010001
10000000200000001100000010001
10000000200000001101010010201
11000001110101011111011110N0111
11110111 1110101 101111010001
11111111 1111111 111111111111

