NO                                      ./textures/paint.xpm 
EA ./textures/pb.xpm 




WE                                                                                   ./textures/rp.xpm 

F 220,100,0
SO ./textures/tt.xpm 





C 225,30,0




1111111111111111111111111
1000001000001100000000001
1011000001110000000000001
1001000000000000000000001
1111111110110000011100001
100000000011000001110111111111111
1111011111111111111111111
11  1     11             1
11   11  11
11111111111111       11111
11000000111001111111111111111
11110111111111011101010010001
11000000110101011100000010001
10000000000000001100000010001
10000000000000001101010010001
11000001110101011111011110N0111
11110111 1110101 101111010001
11111111 1111111 111111111111