NO                                      ./path_to_the_north_texture
EA ./path_to_the_east_texture




WE                                                                                   ./path_to_the_west_texture

F 220,100,0
SO ./path_to_the_south_texture





C 225,30,0




11111111111111111111111111
100000100000110000000000001
10110000011100000000000011
100100000000000000000000111111111
111111111011000001110000000000001
100000000011000001110111111111111
1111011111  11111	1
11       11             						1
11   11  11
1111111111111
110000001110011   1 1 11 111
11110111111111011101010010001
11000000110101011100000010001
10000000000000001100000010001
10000000000000001101010010001
11000001110101011111011110N0111
11110111 1110101 101111010001
11111111 1111111 111111111111